ql1	ql2	ql3
What are the terrestrial planets in our Solar System?	What are the planets in our Solar System?	What are the planets in our Solar System excluding the terrestrial planets?
What are the primary colors in the subtractive color model?	What are the primary colors in the additive color model?	What are the primary colors in the additive color model excluding those in the subtractive color model?
Which permanent members of the UN Security Council are in Europe?	What countries are permanent members of the UN Security Council?	Which permanent members of the UN Security Council are not in Europe?
Which of the fundamental forces of nature have an infinite range?	What are the four fundamental forces of nature?	Which of the four fundamental forces of nature have a finite range?
Which members of the Beatles were left-handed?	Who were the members of the Beatles?	Which members of the Beatles were right-handed?
Which oceans border the continent of North America?	What are the major oceans of the world?	Which major oceans of the world do not border the continent of North America?
Which noble gases are lighter than air?	What are the noble gases on the periodic table?	Which noble gases on the periodic table are not lighter than air?
What are Shakespeare's major tragedies?	What are the plays written by William Shakespeare?	What are the plays written by William Shakespeare excluding his major tragedies?
Which components of a modern desktop computer are considered primary storage?	What are the main components of a modern desktop computer?	Which components of a modern desktop computer are not considered primary storage?
What are the water signs of the Zodiac?	What are the twelve signs of the Zodiac?	What are the signs of the Zodiac excluding the water signs?
Which continents are crossed by the Equator?	What are the continents of the Earth?	Which continents are not crossed by the Equator?
"Which of the major Hollywood film studios are part of the ""Big Five""?"	What are some of the major film studios in Hollywood?	"Which major Hollywood film studios are not part of the ""Big Five""?"
Which instruments in a standard string quartet are typically played while seated?	What are the instruments in a standard string quartet?	Which instruments in a standard string quartet are typically played while standing?
Which G7 member countries are located in North America?	What are the G7 member countries?	Which G7 member countries are not located in North America?
Which of Switzerland's official languages are Romance languages?	What are the official languages of Switzerland?	Which of Switzerland's official languages are not Romance languages?
Which types of taste buds detect savory flavors?	What are the different types of taste buds on the human tongue?	What are the different types of taste buds on the human tongue excluding those that detect savory flavors?
Which books of the Pentateuch primarily contain laws and commandments?	What are the books of the Pentateuch in the Old Testament?	Which books of the Pentateuch do not primarily contain laws and commandments?
What states of matter are considered fluids?	What are the states of matter?	What states of matter are not considered fluids?
Which popular object-oriented programming languages are developed by Microsoft?	What are some popular object-oriented programming languages?	Which popular object-oriented programming languages are not developed by Microsoft?
Which of the twelve Olympian gods were children of Zeus and Hera?	Who are the twelve Olympian gods in Greek mythology?	Which of the twelve Olympian gods are not children of Zeus and Hera?
What are the terrestrial planets in our Solar System?	What are the planets in our Solar System?	What are the planets in our Solar System excluding the terrestrial planets?
What countries in the United Kingdom are not on the island of Great Britain?	What countries are in the United Kingdom?	What countries in the United Kingdom are on the island of Great Britain?
What are the studio albums released by Led Zeppelin in the 1970s?	What are the studio albums released by Led Zeppelin?	What are the studio albums released by Led Zeppelin excluding those released in the 1970s?
Which fundamental forces of physics are described by the Standard Model?	What are the fundamental forces of physics?	Which fundamental forces of physics are not described by the Standard Model?
Which teams in the NBA are in the Pacific Division?	Which teams compete in the National Basketball Association (NBA)?	Which teams compete in the National Basketball Association (NBA) excluding those in the Pacific Division?
Which of Switzerland's official languages are also official languages of the European Union?	What are the official languages of Switzerland?	What are the official languages of Switzerland that are not official languages of the European Union?
What are the historical plays commonly attributed to William Shakespeare?	What are the plays commonly attributed to William Shakespeare?	What are the plays commonly attributed to William Shakespeare excluding those that are historical plays?
Which oceans border the continent of North America?	What are the oceans of the world?	Which oceans do not border the continent of North America?
Which of the twelve Olympian gods were children of Zeus?	Who are the twelve Olympian gods of Greek mythology?	Which of the twelve Olympian gods are not children of Zeus?
Which primary colors in the RGB color model are used to create the color yellow?	What are the primary colors in the RGB color model?	Which primary colors in the RGB color model are not used to create the color yellow?
Which European countries have won the FIFA Men's World Cup?	Which countries have won the FIFA Men's World Cup?	Which countries that have won the FIFA Men's World Cup are not in Europe?
Which components of a eukaryotic cell are enclosed by a double membrane?	What are the main components of a eukaryotic cell?	Which main components of a eukaryotic cell are not enclosed by a double membrane?
Which films directed by Stanley Kubrick were released in color?	Which films were directed by Stanley Kubrick?	Which films directed by Stanley Kubrick were not released in color?
Which noble gases have an atomic number less than 50?	What are the noble gases on the periodic table?	Which noble gases have an atomic number of 50 or greater?
Which continents lie entirely in the Southern Hemisphere?	What are the continents of the Earth?	Which continents do not lie entirely in the Southern Hemisphere?
What are the Gospels in the New Testament?	What are the books of the New Testament?	What are the books of the New Testament excluding the Gospels?
Which chess pieces can move diagonally?	What are the pieces used in the game of chess?	Which chess pieces can move but not diagonally?
What are some major web browsers that use the Chromium engine?	What are some major web browsers?	What are some major web browsers that do not use the Chromium engine?
Which permanent member states of the UN Security Council are in Asia?	What are the permanent member states of the UN Security Council?	Which permanent member states of the UN Security Council are not in Asia?
What are the bones in the human forearm?	What are the bones in the human arm?	What are the bones in the human arm excluding those in the human forearm?
What are the water signs of the Zodiac?	What are the signs of the Zodiac?	What are the signs of the Zodiac excluding the water signs?
Which of the five French mother sauces are based on a white stock?	What are the five mother sauces of classical French cuisine?	Which of the five mother sauces of classical French cuisine are not based on a white stock?
Which American actors have portrayed Batman in live-action films?	Which actors have portrayed Batman in live-action films?	Which actors who have portrayed Batman in live-action films are not American?
Which of the Great Lakes of North America border the state of Michigan?	What are the Great Lakes of North America?	Which of the Great Lakes of North America do not border the state of Michigan?
What are some common object-oriented programming languages developed in the 1990s?	What are some common object-oriented programming languages?	What are some common object-oriented programming languages that were not developed in the 1990s?
Which of the Seven Wonders of the Ancient World were located in modern-day Egypt?	What are the Seven Wonders of the Ancient World?	Which of the Seven Wonders of the Ancient World were located outside modern-day Egypt?
Which of the four main islands of Japan are connected to Honshu by bridges or tunnels?	What are the four main islands of Japan?	Which of the four main islands of Japan are not connected to Honshu by bridges or tunnels?
Which vitamins are fat-soluble?	What are the main types of vitamins?	Which vitamins are water-soluble, excluding the fat-soluble vitamins?
Who were the founding members of the rock band Queen?	What are the members of the rock band Queen?	Who are the members of the rock band Queen excluding the founding members?
Which countries in Scandinavia are monarchies?	What are the countries in Scandinavia?	Which countries in Scandinavia are not monarchies?
What continents are crossed by the Prime Meridian?	What are the continents of the world?	What continents of the world are not crossed by the Prime Meridian?
What are the gas giants in our Solar System?	What are the planets in our Solar System?	What are the planets in our Solar System excluding the gas giants?
What organ systems are primarily involved in movement and support?	What are the major organ systems in the human body?	Which major organ systems in the human body are not primarily involved in movement and support?
What member countries of the European Union use the Euro as their currency?	What are the member countries of the European Union?	Which member countries of the European Union do not use the Euro as their currency?
What oceans border the continent of North America?	What are the world's oceans?	What are the world's oceans excluding those that border the continent of North America?
Which noble gases are commonly used in lighting?	What are the noble gases on the periodic table?	Which noble gases on the periodic table are not commonly used in lighting?
Which South American countries have won the men's FIFA World Cup?	Which countries have won the men's FIFA World Cup?	Which countries have won the men's FIFA World Cup excluding those South American countries?
Which books in the 'Harry Potter' series are named after magical objects?	What are the books in the 'Harry Potter' series?	Which books in the 'Harry Potter' series are not named after magical objects?
What are the instruments in the woodwind family of an orchestra?	What are the instrument families in a symphony orchestra?	What are the instrument families in a symphony orchestra excluding the woodwind family?
What are some major programming languages developed at Bell Labs?	What are some major programming languages?	What are some major programming languages not developed at Bell Labs?
Which of the Seven Wonders of the Ancient World were located in modern-day Greece?	What were the Seven Wonders of the Ancient World?	Which of the Seven Wonders of the Ancient World were not located in modern-day Greece?
What are the primary colors in the additive (RGB) color model?	What are the primary colors in the additive and subtractive color models?	What are the primary colors in the subtractive color model, excluding those in the additive (RGB) color model?
Which Grand Slam tournaments are played on clay or grass courts?	What are the four Grand Slam tournaments in tennis?	Which Grand Slam tournaments are played on hard courts?
Which studio albums by The Beatles were released in the 1960s?	What are some of the studio albums released by The Beatles?	Which studio albums released by The Beatles were not released in the 1960s?
What are the water signs of the Zodiac?	What are the twelve signs of the Zodiac?	What are the signs of the Zodiac excluding the water signs?
Which fundamental forces have an infinite range?	What are the fundamental forces of nature?	Which fundamental forces of nature do not have an infinite range?
What are some types of pasta that are typically stuffed?	What are some common types of pasta?	What are some common types of pasta that are not typically stuffed?
Which members of the Fellowship of the Ring are not Hobbits?	Who are the members of the Fellowship of the Ring?	Which members of the Fellowship of the Ring are Hobbits?
Which official languages of the United Nations are Romance languages?	What are the official languages of the United Nations?	What are the official languages of the United Nations that are not Romance languages?
What are the primary data storage components inside a modern computer?	What are the core components inside a modern desktop computer?	What are the core components inside a modern desktop computer excluding the primary data storage components?
Which major German car manufacturers are part of the Volkswagen Group?	What are some major German car manufacturers?	Which major German car manufacturers are not part of the Volkswagen Group?
What are the red suits in a standard 52-card deck?	What are the suits in a standard 52-card deck of playing cards?	What are the suits in a standard 52-card deck excluding the red suits?
Which of the twelve Olympian gods are sons of Cronus and Rhea?	Who are the twelve Olympian gods in Greek mythology?	Which of the twelve Olympian gods are not sons of Cronus and Rhea?
What are some aquatic sports included in the Summer Olympics?	What are some sports included in the Summer Olympics?	What are some sports included in the Summer Olympics excluding the aquatic sports?
Which Christopher Nolan films are part of 'The Dark Knight Trilogy'?	What films were directed by Christopher Nolan?	Which Christopher Nolan films are not part of 'The Dark Knight Trilogy'?
Which G7 member countries are located in Europe?	What are the member countries of the G7?	Which G7 member countries are not located in Europe?
Which of the five human senses are considered chemical senses?	What are the five human senses?	Which of the five human senses are not considered chemical senses?
Which permanent member states of the UN Security Council are in the Eastern Hemisphere?	What are the permanent member states of the UN Security Council?	Which permanent member states of the UN Security Council are not in the Eastern Hemisphere?
Which major social media platforms are owned by Meta?	What are some major social media platforms?	Which major social media platforms are not owned by Meta?
What types of citrus fruits are hybrids?	What are some common types of citrus fruits?	What types of common citrus fruits are not hybrids?
What are the gas giants in our Solar System?	What are the planets in our Solar System?	What are the planets in our Solar System excluding the gas giants?
What are the member states of the G7?	What are the member states of the G20?	What are the member states of the G20 that are not members of the G7?
What are the string instruments in a standard symphony orchestra?	What are the instruments in a standard symphony orchestra?	What are the instruments in a standard symphony orchestra excluding the string instruments?
Which Allied powers from World War II are permanent members of the UN Security Council?	Which countries were the primary Allied powers in World War II?	Which countries were the primary Allied powers in World War II excluding those that are permanent members of the UN Security Council?
What are some popular object-oriented programming languages?	What are some popular high-level programming languages?	What are some popular high-level programming languages that are not object-oriented?
What continents are located at least partially in the Western Hemisphere?	What are the seven continents of the world?	Which continents are not located at least partially in the Western Hemisphere?
What tragedies were written by William Shakespeare?	What plays were written by William Shakespeare?	What plays written by William Shakespeare are not tragedies?
Which noble gases have been observed to form chemical compounds?	What are the noble gases?	Which noble gases have not been observed to form chemical compounds?
Which actors have won the Academy Award for Best Actor at least twice?	Which actors have won an Academy Award for Best Actor?	Which actors have won an Academy Award for Best Actor exactly once?
What are the primary colors of light in the additive color model?	What are the colors in a standard rainbow?	What are the colors in a standard rainbow excluding the primary colors of light in the additive color model?
Which NFL teams are based in the state of California?	Which teams play in the National Football League (NFL)?	Which NFL teams are not based in the state of California?
Which of the twelve Olympians were children of Zeus?	Who are the twelve Olympian gods and goddesses in Greek mythology?	Which of the twelve Olympian gods and goddesses in Greek mythology are not children of Zeus?
Which Japanese car manufacturers also produce luxury vehicle brands?	What are some major Japanese car manufacturers?	Which major Japanese car manufacturers do not produce luxury vehicle brands?
Which Grand Slam tournaments are not played on a hard court?	What are the four major Grand Slam tournaments in tennis?	Which Grand Slam tournaments are played on a hard court?
Which of the fundamental forces have an infinite range?	What are the four fundamental forces of nature?	Which of the fundamental forces of nature have a finite range?
What are some common types of filled pasta?	What are some common types of pasta?	What are some common types of pasta that are not filled pasta?
Who are the three artists that comprise the traditional trinity of great masters of the High Renaissance?	Who are some famous artists of the High Renaissance period?	Who are some famous artists of the High Renaissance period excluding the three artists that comprise the traditional trinity of great masters of the High Renaissance?
Which species of great apes are in the genus Pan?	What are the living species of great apes?	Which living species of great apes are not in the genus Pan?
Which FAANG companies were founded in the 1990s?	What companies are components of the FAANG acronym?	Which FAANG companies were not founded in the 1990s?
Which oceans border the continent of Asia?	What are the Earth's five oceans?	Which of the Earth's five oceans do not border the continent of Asia?
